//format: implementation method's signature  	  interface method's signature1  ..2 .. if any
org.apache.hadoop.hdfs.server.namenode.NameNode.getBlocks(Lorg/apache/hadoop/hdfs/protocol/DatanodeInfo;J)Lorg/apache/hadoop/hdfs/server/protocol/BlocksWithLocations;	org.apache.hadoop.hdfs.server.protocol.NamenodeProtocol.getBlocks(Lorg/apache/hadoop/hdfs/protocol/DatanodeInfo;J)Lorg/apache/hadoop/hdfs/server/protocol/BlocksWithLocations;	
org.apache.hadoop.hdfs.server.namenode.NameNode.getDelegationToken(Lorg/apache/hadoop/io/Text;)Lorg/apache/hadoop/security/token/Token;	org.apache.hadoop.hdfs.protocol.ClientProtocol.getDelegationToken(Lorg/apache/hadoop/io/Text;)Lorg/apache/hadoop/security/token/Token;	
org.apache.hadoop.hdfs.server.namenode.NameNode.renewDelegationToken(Lorg/apache/hadoop/security/token/Token;)J	org.apache.hadoop.hdfs.protocol.ClientProtocol.renewDelegationToken(Lorg/apache/hadoop/security/token/Token;)J	
org.apache.hadoop.hdfs.server.namenode.NameNode.cancelDelegationToken(Lorg/apache/hadoop/security/token/Token;)V	org.apache.hadoop.hdfs.protocol.ClientProtocol.cancelDelegationToken(Lorg/apache/hadoop/security/token/Token;)V	
org.apache.hadoop.hdfs.server.namenode.NameNode.getBlockLocations(Ljava/lang/String;JJ)Lorg/apache/hadoop/hdfs/protocol/LocatedBlocks;	org.apache.hadoop.hdfs.protocol.ClientProtocol.getBlockLocations(Ljava/lang/String;JJ)Lorg/apache/hadoop/hdfs/protocol/LocatedBlocks;	
org.apache.hadoop.hdfs.server.namenode.NameNode.create(Ljava/lang/String;Lorg/apache/hadoop/fs/permission/FsPermission;Ljava/lang/String;ZSJ)V	org.apache.hadoop.hdfs.protocol.ClientProtocol.create(Ljava/lang/String;Lorg/apache/hadoop/fs/permission/FsPermission;Ljava/lang/String;ZSJ)V	
org.apache.hadoop.hdfs.server.namenode.NameNode.append(Ljava/lang/String;Ljava/lang/String;)Lorg/apache/hadoop/hdfs/protocol/LocatedBlock;	org.apache.hadoop.hdfs.protocol.ClientProtocol.append(Ljava/lang/String;Ljava/lang/String;)Lorg/apache/hadoop/hdfs/protocol/LocatedBlock;	
org.apache.hadoop.hdfs.server.namenode.NameNode.recoverLease(Ljava/lang/String;Ljava/lang/String;)Z	org.apache.hadoop.hdfs.protocol.ClientProtocol.recoverLease(Ljava/lang/String;Ljava/lang/String;)Z	
org.apache.hadoop.hdfs.server.namenode.NameNode.setReplication(Ljava/lang/String;S)Z	org.apache.hadoop.hdfs.protocol.ClientProtocol.setReplication(Ljava/lang/String;S)Z	
org.apache.hadoop.hdfs.server.namenode.NameNode.setPermission(Ljava/lang/String;Lorg/apache/hadoop/fs/permission/FsPermission;)V	org.apache.hadoop.hdfs.protocol.ClientProtocol.setPermission(Ljava/lang/String;Lorg/apache/hadoop/fs/permission/FsPermission;)V	
org.apache.hadoop.hdfs.server.namenode.NameNode.setOwner(Ljava/lang/String;Ljava/lang/String;Ljava/lang/String;)V	org.apache.hadoop.hdfs.protocol.ClientProtocol.setOwner(Ljava/lang/String;Ljava/lang/String;Ljava/lang/String;)V	
org.apache.hadoop.hdfs.server.namenode.NameNode.addBlock(Ljava/lang/String;Ljava/lang/String;)Lorg/apache/hadoop/hdfs/protocol/LocatedBlock;	org.apache.hadoop.hdfs.protocol.ClientProtocol.addBlock(Ljava/lang/String;Ljava/lang/String;)Lorg/apache/hadoop/hdfs/protocol/LocatedBlock;	
org.apache.hadoop.hdfs.server.namenode.NameNode.addBlock(Ljava/lang/String;Ljava/lang/String;[Lorg/apache/hadoop/hdfs/protocol/DatanodeInfo;)Lorg/apache/hadoop/hdfs/protocol/LocatedBlock;	org.apache.hadoop.hdfs.protocol.ClientProtocol.addBlock(Ljava/lang/String;Ljava/lang/String;[Lorg/apache/hadoop/hdfs/protocol/DatanodeInfo;)Lorg/apache/hadoop/hdfs/protocol/LocatedBlock;	
org.apache.hadoop.hdfs.server.namenode.NameNode.abandonBlock(Lorg/apache/hadoop/hdfs/protocol/Block;Ljava/lang/String;Ljava/lang/String;)V	org.apache.hadoop.hdfs.protocol.ClientProtocol.abandonBlock(Lorg/apache/hadoop/hdfs/protocol/Block;Ljava/lang/String;Ljava/lang/String;)V	
org.apache.hadoop.hdfs.server.namenode.NameNode.complete(Ljava/lang/String;Ljava/lang/String;)Z	org.apache.hadoop.hdfs.protocol.ClientProtocol.complete(Ljava/lang/String;Ljava/lang/String;)Z	
org.apache.hadoop.hdfs.server.namenode.NameNode.reportBadBlocks([Lorg/apache/hadoop/hdfs/protocol/LocatedBlock;)V	org.apache.hadoop.hdfs.protocol.ClientProtocol.reportBadBlocks([Lorg/apache/hadoop/hdfs/protocol/LocatedBlock;)V	org.apache.hadoop.hdfs.server.protocol.DatanodeProtocol.reportBadBlocks([Lorg/apache/hadoop/hdfs/protocol/LocatedBlock;)V	
org.apache.hadoop.hdfs.server.namenode.NameNode.nextGenerationStamp(Lorg/apache/hadoop/hdfs/protocol/Block;Z)J	org.apache.hadoop.hdfs.server.protocol.DatanodeProtocol.nextGenerationStamp(Lorg/apache/hadoop/hdfs/protocol/Block;Z)J	
org.apache.hadoop.hdfs.server.namenode.NameNode.commitBlockSynchronization(Lorg/apache/hadoop/hdfs/protocol/Block;JJZZ[Lorg/apache/hadoop/hdfs/protocol/DatanodeID;)V	org.apache.hadoop.hdfs.server.protocol.DatanodeProtocol.commitBlockSynchronization(Lorg/apache/hadoop/hdfs/protocol/Block;JJZZ[Lorg/apache/hadoop/hdfs/protocol/DatanodeID;)V	
org.apache.hadoop.hdfs.server.namenode.NameNode.getPreferredBlockSize(Ljava/lang/String;)J	org.apache.hadoop.hdfs.protocol.ClientProtocol.getPreferredBlockSize(Ljava/lang/String;)J	
org.apache.hadoop.hdfs.server.namenode.NameNode.rename(Ljava/lang/String;Ljava/lang/String;)Z	org.apache.hadoop.hdfs.protocol.ClientProtocol.rename(Ljava/lang/String;Ljava/lang/String;)Z	
org.apache.hadoop.hdfs.server.namenode.NameNode.delete(Ljava/lang/String;)Z	org.apache.hadoop.hdfs.protocol.ClientProtocol.delete(Ljava/lang/String;)Z	
org.apache.hadoop.hdfs.server.namenode.NameNode.delete(Ljava/lang/String;Z)Z	org.apache.hadoop.hdfs.protocol.ClientProtocol.delete(Ljava/lang/String;Z)Z	
org.apache.hadoop.hdfs.server.namenode.NameNode.mkdirs(Ljava/lang/String;Lorg/apache/hadoop/fs/permission/FsPermission;)Z	org.apache.hadoop.hdfs.protocol.ClientProtocol.mkdirs(Ljava/lang/String;Lorg/apache/hadoop/fs/permission/FsPermission;)Z	
org.apache.hadoop.hdfs.server.namenode.NameNode.renewLease(Ljava/lang/String;)V	org.apache.hadoop.hdfs.protocol.ClientProtocol.renewLease(Ljava/lang/String;)V	
org.apache.hadoop.hdfs.server.namenode.NameNode.getListing(Ljava/lang/String;[B)Lorg/apache/hadoop/hdfs/protocol/DirectoryListing;	org.apache.hadoop.hdfs.protocol.ClientProtocol.getListing(Ljava/lang/String;[B)Lorg/apache/hadoop/hdfs/protocol/DirectoryListing;	
org.apache.hadoop.hdfs.server.namenode.NameNode.getFileInfo(Ljava/lang/String;)Lorg/apache/hadoop/hdfs/protocol/HdfsFileStatus;	org.apache.hadoop.hdfs.protocol.ClientProtocol.getFileInfo(Ljava/lang/String;)Lorg/apache/hadoop/hdfs/protocol/HdfsFileStatus;	
org.apache.hadoop.hdfs.server.namenode.NameNode.getStats()[J	org.apache.hadoop.hdfs.protocol.ClientProtocol.getStats()[J	
org.apache.hadoop.hdfs.server.namenode.NameNode.getDatanodeReport(Lorg/apache/hadoop/hdfs/protocol/FSConstants$DatanodeReportType;)[Lorg/apache/hadoop/hdfs/protocol/DatanodeInfo;	org.apache.hadoop.hdfs.protocol.ClientProtocol.getDatanodeReport(Lorg/apache/hadoop/hdfs/protocol/FSConstants$DatanodeReportType;)[Lorg/apache/hadoop/hdfs/protocol/DatanodeInfo;	
org.apache.hadoop.hdfs.server.namenode.NameNode.setSafeMode(Lorg/apache/hadoop/hdfs/protocol/FSConstants$SafeModeAction;)Z	org.apache.hadoop.hdfs.protocol.ClientProtocol.setSafeMode(Lorg/apache/hadoop/hdfs/protocol/FSConstants$SafeModeAction;)Z	
org.apache.hadoop.hdfs.server.namenode.NameNode.saveNamespace()V	org.apache.hadoop.hdfs.protocol.ClientProtocol.saveNamespace()V	
org.apache.hadoop.hdfs.server.namenode.NameNode.refreshNodes()V	org.apache.hadoop.hdfs.protocol.ClientProtocol.refreshNodes()V	
org.apache.hadoop.hdfs.server.namenode.NameNode.getEditLogSize()J	org.apache.hadoop.hdfs.server.protocol.NamenodeProtocol.getEditLogSize()J	
org.apache.hadoop.hdfs.server.namenode.NameNode.rollEditLog()Lorg/apache/hadoop/hdfs/server/namenode/CheckpointSignature;	org.apache.hadoop.hdfs.server.protocol.NamenodeProtocol.rollEditLog()Lorg/apache/hadoop/hdfs/server/namenode/CheckpointSignature;	
org.apache.hadoop.hdfs.server.namenode.NameNode.rollFsImage()V	org.apache.hadoop.hdfs.server.protocol.NamenodeProtocol.rollFsImage()V	
org.apache.hadoop.hdfs.server.namenode.NameNode.finalizeUpgrade()V	org.apache.hadoop.hdfs.protocol.ClientProtocol.finalizeUpgrade()V	
org.apache.hadoop.hdfs.server.namenode.NameNode.distributedUpgradeProgress(Lorg/apache/hadoop/hdfs/protocol/FSConstants$UpgradeAction;)Lorg/apache/hadoop/hdfs/server/common/UpgradeStatusReport;	org.apache.hadoop.hdfs.protocol.ClientProtocol.distributedUpgradeProgress(Lorg/apache/hadoop/hdfs/protocol/FSConstants$UpgradeAction;)Lorg/apache/hadoop/hdfs/server/common/UpgradeStatusReport;	
org.apache.hadoop.hdfs.server.namenode.NameNode.metaSave(Ljava/lang/String;)V	org.apache.hadoop.hdfs.protocol.ClientProtocol.metaSave(Ljava/lang/String;)V	
org.apache.hadoop.hdfs.server.namenode.NameNode.setBalancerBandwidth(J)V	org.apache.hadoop.hdfs.protocol.ClientProtocol.setBalancerBandwidth(J)V	
org.apache.hadoop.hdfs.server.namenode.NameNode.getContentSummary(Ljava/lang/String;)Lorg/apache/hadoop/fs/ContentSummary;	org.apache.hadoop.hdfs.protocol.ClientProtocol.getContentSummary(Ljava/lang/String;)Lorg/apache/hadoop/fs/ContentSummary;	
org.apache.hadoop.hdfs.server.namenode.NameNode.setQuota(Ljava/lang/String;JJ)V	org.apache.hadoop.hdfs.protocol.ClientProtocol.setQuota(Ljava/lang/String;JJ)V	
org.apache.hadoop.hdfs.server.namenode.NameNode.fsync(Ljava/lang/String;Ljava/lang/String;)V	org.apache.hadoop.hdfs.protocol.ClientProtocol.fsync(Ljava/lang/String;Ljava/lang/String;)V	
org.apache.hadoop.hdfs.server.namenode.NameNode.setTimes(Ljava/lang/String;JJ)V	org.apache.hadoop.hdfs.protocol.ClientProtocol.setTimes(Ljava/lang/String;JJ)V	
org.apache.hadoop.hdfs.server.namenode.NameNode.register(Lorg/apache/hadoop/hdfs/server/protocol/DatanodeRegistration;)Lorg/apache/hadoop/hdfs/server/protocol/DatanodeRegistration;	org.apache.hadoop.hdfs.server.protocol.DatanodeProtocol.register(Lorg/apache/hadoop/hdfs/server/protocol/DatanodeRegistration;)Lorg/apache/hadoop/hdfs/server/protocol/DatanodeRegistration;	
org.apache.hadoop.hdfs.server.namenode.NameNode.sendHeartbeat(Lorg/apache/hadoop/hdfs/server/protocol/DatanodeRegistration;JJJII)[Lorg/apache/hadoop/hdfs/server/protocol/DatanodeCommand;	org.apache.hadoop.hdfs.server.protocol.DatanodeProtocol.sendHeartbeat(Lorg/apache/hadoop/hdfs/server/protocol/DatanodeRegistration;JJJII)[Lorg/apache/hadoop/hdfs/server/protocol/DatanodeCommand;	
org.apache.hadoop.hdfs.server.namenode.NameNode.blockReport(Lorg/apache/hadoop/hdfs/server/protocol/DatanodeRegistration;[J)Lorg/apache/hadoop/hdfs/server/protocol/DatanodeCommand;	org.apache.hadoop.hdfs.server.protocol.DatanodeProtocol.blockReport(Lorg/apache/hadoop/hdfs/server/protocol/DatanodeRegistration;[J)Lorg/apache/hadoop/hdfs/server/protocol/DatanodeCommand;	
org.apache.hadoop.hdfs.server.namenode.NameNode.blocksBeingWrittenReport(Lorg/apache/hadoop/hdfs/server/protocol/DatanodeRegistration;[J)V	org.apache.hadoop.hdfs.server.protocol.DatanodeProtocol.blocksBeingWrittenReport(Lorg/apache/hadoop/hdfs/server/protocol/DatanodeRegistration;[J)V	
org.apache.hadoop.hdfs.server.namenode.NameNode.blockReceived(Lorg/apache/hadoop/hdfs/server/protocol/DatanodeRegistration;[Lorg/apache/hadoop/hdfs/protocol/Block;[Ljava/lang/String;)V	org.apache.hadoop.hdfs.server.protocol.DatanodeProtocol.blockReceived(Lorg/apache/hadoop/hdfs/server/protocol/DatanodeRegistration;[Lorg/apache/hadoop/hdfs/protocol/Block;[Ljava/lang/String;)V	
org.apache.hadoop.hdfs.server.namenode.NameNode.getBlockKeys()Lorg/apache/hadoop/hdfs/security/token/block/ExportedBlockKeys;	org.apache.hadoop.hdfs.server.protocol.NamenodeProtocol.getBlockKeys()Lorg/apache/hadoop/hdfs/security/token/block/ExportedBlockKeys;	
org.apache.hadoop.hdfs.server.namenode.NameNode.errorReport(Lorg/apache/hadoop/hdfs/server/protocol/DatanodeRegistration;ILjava/lang/String;)V	org.apache.hadoop.hdfs.server.protocol.DatanodeProtocol.errorReport(Lorg/apache/hadoop/hdfs/server/protocol/DatanodeRegistration;ILjava/lang/String;)V	
org.apache.hadoop.hdfs.server.namenode.NameNode.versionRequest()Lorg/apache/hadoop/hdfs/server/protocol/NamespaceInfo;	org.apache.hadoop.hdfs.server.protocol.DatanodeProtocol.versionRequest()Lorg/apache/hadoop/hdfs/server/protocol/NamespaceInfo;	
org.apache.hadoop.hdfs.server.namenode.NameNode.processUpgradeCommand(Lorg/apache/hadoop/hdfs/server/protocol/UpgradeCommand;)Lorg/apache/hadoop/hdfs/server/protocol/UpgradeCommand;	org.apache.hadoop.hdfs.server.protocol.DatanodeProtocol.processUpgradeCommand(Lorg/apache/hadoop/hdfs/server/protocol/UpgradeCommand;)Lorg/apache/hadoop/hdfs/server/protocol/UpgradeCommand;	
org.apache.hadoop.hdfs.server.datanode.DataNode.getBlockMetaDataInfo(Lorg/apache/hadoop/hdfs/protocol/Block;)Lorg/apache/hadoop/hdfs/server/protocol/BlockMetaDataInfo;	org.apache.hadoop.hdfs.server.protocol.InterDatanodeProtocol.getBlockMetaDataInfo(Lorg/apache/hadoop/hdfs/protocol/Block;)Lorg/apache/hadoop/hdfs/server/protocol/BlockMetaDataInfo;	
org.apache.hadoop.hdfs.server.datanode.DataNode.startBlockRecovery(Lorg/apache/hadoop/hdfs/protocol/Block;)Lorg/apache/hadoop/hdfs/server/protocol/BlockRecoveryInfo;	org.apache.hadoop.hdfs.server.protocol.InterDatanodeProtocol.startBlockRecovery(Lorg/apache/hadoop/hdfs/protocol/Block;)Lorg/apache/hadoop/hdfs/server/protocol/BlockRecoveryInfo;	
org.apache.hadoop.hdfs.server.datanode.DataNode.updateBlock(Lorg/apache/hadoop/hdfs/protocol/Block;Lorg/apache/hadoop/hdfs/protocol/Block;Z)V	org.apache.hadoop.hdfs.server.protocol.InterDatanodeProtocol.updateBlock(Lorg/apache/hadoop/hdfs/protocol/Block;Lorg/apache/hadoop/hdfs/protocol/Block;Z)V	
org.apache.hadoop.hdfs.server.datanode.DataNode.recoverBlock(Lorg/apache/hadoop/hdfs/protocol/Block;Z[Lorg/apache/hadoop/hdfs/protocol/DatanodeInfo;)Lorg/apache/hadoop/hdfs/protocol/LocatedBlock;	org.apache.hadoop.hdfs.protocol.ClientDatanodeProtocol.recoverBlock(Lorg/apache/hadoop/hdfs/protocol/Block;Z[Lorg/apache/hadoop/hdfs/protocol/DatanodeInfo;)Lorg/apache/hadoop/hdfs/protocol/LocatedBlock;	
org.apache.hadoop.hdfs.server.datanode.DataNode.getBlockInfo(Lorg/apache/hadoop/hdfs/protocol/Block;)Lorg/apache/hadoop/hdfs/protocol/Block;	org.apache.hadoop.hdfs.protocol.ClientDatanodeProtocol.getBlockInfo(Lorg/apache/hadoop/hdfs/protocol/Block;)Lorg/apache/hadoop/hdfs/protocol/Block;	
org.apache.hadoop.hdfs.server.datanode.DataNode.<clinit>()V	org.apache.hadoop.hdfs.server.protocol.InterDatanodeProtocol.<clinit>()V	org.apache.hadoop.hdfs.protocol.ClientDatanodeProtocol.<clinit>()V	
