//format: implementation method's signature  	  interface method's signature1  ..2 .. if any

org.apache.hadoop.mapred.LocalJobRunner.getNewJobId()Lorg/apache/hadoop/mapred/JobID;	org.apache.hadoop.mapred.JobSubmissionProtocol.getNewJobId()Lorg/apache/hadoop/mapred/JobID;	
org.apache.hadoop.mapred.LocalJobRunner.submitJob(Lorg/apache/hadoop/mapred/JobID;Ljava/lang/String;Lorg/apache/hadoop/security/Credentials;)Lorg/apache/hadoop/mapred/JobStatus;	org.apache.hadoop.mapred.JobSubmissionProtocol.submitJob(Lorg/apache/hadoop/mapred/JobID;Ljava/lang/String;Lorg/apache/hadoop/security/Credentials;)Lorg/apache/hadoop/mapred/JobStatus;	
org.apache.hadoop.mapred.LocalJobRunner.killJob(Lorg/apache/hadoop/mapred/JobID;)V	org.apache.hadoop.mapred.JobSubmissionProtocol.killJob(Lorg/apache/hadoop/mapred/JobID;)V	
org.apache.hadoop.mapred.LocalJobRunner.setJobPriority(Lorg/apache/hadoop/mapred/JobID;Ljava/lang/String;)V	org.apache.hadoop.mapred.JobSubmissionProtocol.setJobPriority(Lorg/apache/hadoop/mapred/JobID;Ljava/lang/String;)V	
org.apache.hadoop.mapred.LocalJobRunner.killTask(Lorg/apache/hadoop/mapred/TaskAttemptID;Z)Z	org.apache.hadoop.mapred.JobSubmissionProtocol.killTask(Lorg/apache/hadoop/mapred/TaskAttemptID;Z)Z	
org.apache.hadoop.mapred.LocalJobRunner.getJobProfile(Lorg/apache/hadoop/mapred/JobID;)Lorg/apache/hadoop/mapred/JobProfile;	org.apache.hadoop.mapred.JobSubmissionProtocol.getJobProfile(Lorg/apache/hadoop/mapred/JobID;)Lorg/apache/hadoop/mapred/JobProfile;	
org.apache.hadoop.mapred.LocalJobRunner.getMapTaskReports(Lorg/apache/hadoop/mapred/JobID;)[Lorg/apache/hadoop/mapred/TaskReport;	org.apache.hadoop.mapred.JobSubmissionProtocol.getMapTaskReports(Lorg/apache/hadoop/mapred/JobID;)[Lorg/apache/hadoop/mapred/TaskReport;	
org.apache.hadoop.mapred.LocalJobRunner.getReduceTaskReports(Lorg/apache/hadoop/mapred/JobID;)[Lorg/apache/hadoop/mapred/TaskReport;	org.apache.hadoop.mapred.JobSubmissionProtocol.getReduceTaskReports(Lorg/apache/hadoop/mapred/JobID;)[Lorg/apache/hadoop/mapred/TaskReport;	
org.apache.hadoop.mapred.LocalJobRunner.getCleanupTaskReports(Lorg/apache/hadoop/mapred/JobID;)[Lorg/apache/hadoop/mapred/TaskReport;	org.apache.hadoop.mapred.JobSubmissionProtocol.getCleanupTaskReports(Lorg/apache/hadoop/mapred/JobID;)[Lorg/apache/hadoop/mapred/TaskReport;	
org.apache.hadoop.mapred.LocalJobRunner.getSetupTaskReports(Lorg/apache/hadoop/mapred/JobID;)[Lorg/apache/hadoop/mapred/TaskReport;	org.apache.hadoop.mapred.JobSubmissionProtocol.getSetupTaskReports(Lorg/apache/hadoop/mapred/JobID;)[Lorg/apache/hadoop/mapred/TaskReport;	
org.apache.hadoop.mapred.LocalJobRunner.getJobStatus(Lorg/apache/hadoop/mapred/JobID;)Lorg/apache/hadoop/mapred/JobStatus;	org.apache.hadoop.mapred.JobSubmissionProtocol.getJobStatus(Lorg/apache/hadoop/mapred/JobID;)Lorg/apache/hadoop/mapred/JobStatus;	
org.apache.hadoop.mapred.LocalJobRunner.getJobCounters(Lorg/apache/hadoop/mapred/JobID;)Lorg/apache/hadoop/mapred/Counters;	org.apache.hadoop.mapred.JobSubmissionProtocol.getJobCounters(Lorg/apache/hadoop/mapred/JobID;)Lorg/apache/hadoop/mapred/Counters;	
org.apache.hadoop.mapred.LocalJobRunner.getFilesystemName()Ljava/lang/String;	org.apache.hadoop.mapred.JobSubmissionProtocol.getFilesystemName()Ljava/lang/String;	
org.apache.hadoop.mapred.LocalJobRunner.getClusterStatus(Z)Lorg/apache/hadoop/mapred/ClusterStatus;	org.apache.hadoop.mapred.JobSubmissionProtocol.getClusterStatus(Z)Lorg/apache/hadoop/mapred/ClusterStatus;	
org.apache.hadoop.mapred.LocalJobRunner.jobsToComplete()[Lorg/apache/hadoop/mapred/JobStatus;	org.apache.hadoop.mapred.JobSubmissionProtocol.jobsToComplete()[Lorg/apache/hadoop/mapred/JobStatus;	
org.apache.hadoop.mapred.LocalJobRunner.getTaskCompletionEvents(Lorg/apache/hadoop/mapred/JobID;II)[Lorg/apache/hadoop/mapred/TaskCompletionEvent;	org.apache.hadoop.mapred.JobSubmissionProtocol.getTaskCompletionEvents(Lorg/apache/hadoop/mapred/JobID;II)[Lorg/apache/hadoop/mapred/TaskCompletionEvent;	
org.apache.hadoop.mapred.LocalJobRunner.getAllJobs()[Lorg/apache/hadoop/mapred/JobStatus;	org.apache.hadoop.mapred.JobSubmissionProtocol.getAllJobs()[Lorg/apache/hadoop/mapred/JobStatus;	
org.apache.hadoop.mapred.LocalJobRunner.getTaskDiagnostics(Lorg/apache/hadoop/mapred/TaskAttemptID;)[Ljava/lang/String;	org.apache.hadoop.mapred.JobSubmissionProtocol.getTaskDiagnostics(Lorg/apache/hadoop/mapred/TaskAttemptID;)[Ljava/lang/String;	
org.apache.hadoop.mapred.LocalJobRunner.getSystemDir()Ljava/lang/String;	org.apache.hadoop.mapred.JobSubmissionProtocol.getSystemDir()Ljava/lang/String;	
org.apache.hadoop.mapred.LocalJobRunner.getQueueAdmins(Ljava/lang/String;)Lorg/apache/hadoop/security/authorize/AccessControlList;	org.apache.hadoop.mapred.JobSubmissionProtocol.getQueueAdmins(Ljava/lang/String;)Lorg/apache/hadoop/security/authorize/AccessControlList;	
org.apache.hadoop.mapred.LocalJobRunner.getStagingAreaDir()Ljava/lang/String;	org.apache.hadoop.mapred.JobSubmissionProtocol.getStagingAreaDir()Ljava/lang/String;	
org.apache.hadoop.mapred.LocalJobRunner.getJobsFromQueue(Ljava/lang/String;)[Lorg/apache/hadoop/mapred/JobStatus;	org.apache.hadoop.mapred.JobSubmissionProtocol.getJobsFromQueue(Ljava/lang/String;)[Lorg/apache/hadoop/mapred/JobStatus;	
org.apache.hadoop.mapred.LocalJobRunner.getQueues()[Lorg/apache/hadoop/mapred/JobQueueInfo;	org.apache.hadoop.mapred.JobSubmissionProtocol.getQueues()[Lorg/apache/hadoop/mapred/JobQueueInfo;	
org.apache.hadoop.mapred.LocalJobRunner.getQueueInfo(Ljava/lang/String;)Lorg/apache/hadoop/mapred/JobQueueInfo;	org.apache.hadoop.mapred.JobSubmissionProtocol.getQueueInfo(Ljava/lang/String;)Lorg/apache/hadoop/mapred/JobQueueInfo;	
org.apache.hadoop.mapred.LocalJobRunner.getQueueAclsForCurrentUser()[Lorg/apache/hadoop/mapred/QueueAclsInfo;	org.apache.hadoop.mapred.JobSubmissionProtocol.getQueueAclsForCurrentUser()[Lorg/apache/hadoop/mapred/QueueAclsInfo;	
org.apache.hadoop.mapred.LocalJobRunner.cancelDelegationToken(Lorg/apache/hadoop/security/token/Token;)V	org.apache.hadoop.mapred.JobSubmissionProtocol.cancelDelegationToken(Lorg/apache/hadoop/security/token/Token;)V	
org.apache.hadoop.mapred.LocalJobRunner.getDelegationToken(Lorg/apache/hadoop/io/Text;)Lorg/apache/hadoop/security/token/Token;	org.apache.hadoop.mapred.JobSubmissionProtocol.getDelegationToken(Lorg/apache/hadoop/io/Text;)Lorg/apache/hadoop/security/token/Token;	
org.apache.hadoop.mapred.LocalJobRunner.renewDelegationToken(Lorg/apache/hadoop/security/token/Token;)J	org.apache.hadoop.mapred.JobSubmissionProtocol.renewDelegationToken(Lorg/apache/hadoop/security/token/Token;)J	
org.apache.hadoop.mapred.IsolationRunner$FakeUmbilical.done(Lorg/apache/hadoop/mapred/TaskAttemptID;Lorg/apache/hadoop/mapred/JvmContext;)V	org.apache.hadoop.mapred.TaskUmbilicalProtocol.done(Lorg/apache/hadoop/mapred/TaskAttemptID;Lorg/apache/hadoop/mapred/JvmContext;)V	
org.apache.hadoop.mapred.IsolationRunner$FakeUmbilical.fsError(Lorg/apache/hadoop/mapred/TaskAttemptID;Ljava/lang/String;Lorg/apache/hadoop/mapred/JvmContext;)V	org.apache.hadoop.mapred.TaskUmbilicalProtocol.fsError(Lorg/apache/hadoop/mapred/TaskAttemptID;Ljava/lang/String;Lorg/apache/hadoop/mapred/JvmContext;)V	
org.apache.hadoop.mapred.IsolationRunner$FakeUmbilical.shuffleError(Lorg/apache/hadoop/mapred/TaskAttemptID;Ljava/lang/String;Lorg/apache/hadoop/mapred/JvmContext;)V	org.apache.hadoop.mapred.TaskUmbilicalProtocol.shuffleError(Lorg/apache/hadoop/mapred/TaskAttemptID;Ljava/lang/String;Lorg/apache/hadoop/mapred/JvmContext;)V	
org.apache.hadoop.mapred.IsolationRunner$FakeUmbilical.fatalError(Lorg/apache/hadoop/mapred/TaskAttemptID;Ljava/lang/String;Lorg/apache/hadoop/mapred/JvmContext;)V	org.apache.hadoop.mapred.TaskUmbilicalProtocol.fatalError(Lorg/apache/hadoop/mapred/TaskAttemptID;Ljava/lang/String;Lorg/apache/hadoop/mapred/JvmContext;)V	
org.apache.hadoop.mapred.IsolationRunner$FakeUmbilical.getTask(Lorg/apache/hadoop/mapred/JvmContext;)Lorg/apache/hadoop/mapred/JvmTask;	org.apache.hadoop.mapred.TaskUmbilicalProtocol.getTask(Lorg/apache/hadoop/mapred/JvmContext;)Lorg/apache/hadoop/mapred/JvmTask;	
org.apache.hadoop.mapred.IsolationRunner$FakeUmbilical.ping(Lorg/apache/hadoop/mapred/TaskAttemptID;Lorg/apache/hadoop/mapred/JvmContext;)Z	org.apache.hadoop.mapred.TaskUmbilicalProtocol.ping(Lorg/apache/hadoop/mapred/TaskAttemptID;Lorg/apache/hadoop/mapred/JvmContext;)Z	
org.apache.hadoop.mapred.IsolationRunner$FakeUmbilical.commitPending(Lorg/apache/hadoop/mapred/TaskAttemptID;Lorg/apache/hadoop/mapred/TaskStatus;Lorg/apache/hadoop/mapred/JvmContext;)V	org.apache.hadoop.mapred.TaskUmbilicalProtocol.commitPending(Lorg/apache/hadoop/mapred/TaskAttemptID;Lorg/apache/hadoop/mapred/TaskStatus;Lorg/apache/hadoop/mapred/JvmContext;)V	
org.apache.hadoop.mapred.IsolationRunner$FakeUmbilical.canCommit(Lorg/apache/hadoop/mapred/TaskAttemptID;Lorg/apache/hadoop/mapred/JvmContext;)Z	org.apache.hadoop.mapred.TaskUmbilicalProtocol.canCommit(Lorg/apache/hadoop/mapred/TaskAttemptID;Lorg/apache/hadoop/mapred/JvmContext;)Z	
org.apache.hadoop.mapred.IsolationRunner$FakeUmbilical.statusUpdate(Lorg/apache/hadoop/mapred/TaskAttemptID;Lorg/apache/hadoop/mapred/TaskStatus;Lorg/apache/hadoop/mapred/JvmContext;)Z	org.apache.hadoop.mapred.TaskUmbilicalProtocol.statusUpdate(Lorg/apache/hadoop/mapred/TaskAttemptID;Lorg/apache/hadoop/mapred/TaskStatus;Lorg/apache/hadoop/mapred/JvmContext;)Z	
org.apache.hadoop.mapred.IsolationRunner$FakeUmbilical.reportDiagnosticInfo(Lorg/apache/hadoop/mapred/TaskAttemptID;Ljava/lang/String;Lorg/apache/hadoop/mapred/JvmContext;)V	org.apache.hadoop.mapred.TaskUmbilicalProtocol.reportDiagnosticInfo(Lorg/apache/hadoop/mapred/TaskAttemptID;Ljava/lang/String;Lorg/apache/hadoop/mapred/JvmContext;)V	
org.apache.hadoop.mapred.IsolationRunner$FakeUmbilical.getMapCompletionEvents(Lorg/apache/hadoop/mapred/JobID;IILorg/apache/hadoop/mapred/TaskAttemptID;Lorg/apache/hadoop/mapred/JvmContext;)Lorg/apache/hadoop/mapred/MapTaskCompletionEventsUpdate;	org.apache.hadoop.mapred.TaskUmbilicalProtocol.getMapCompletionEvents(Lorg/apache/hadoop/mapred/JobID;IILorg/apache/hadoop/mapred/TaskAttemptID;Lorg/apache/hadoop/mapred/JvmContext;)Lorg/apache/hadoop/mapred/MapTaskCompletionEventsUpdate;	
org.apache.hadoop.mapred.IsolationRunner$FakeUmbilical.reportNextRecordRange(Lorg/apache/hadoop/mapred/TaskAttemptID;Lorg/apache/hadoop/mapred/SortedRanges$Range;Lorg/apache/hadoop/mapred/JvmContext;)V	org.apache.hadoop.mapred.TaskUmbilicalProtocol.reportNextRecordRange(Lorg/apache/hadoop/mapred/TaskAttemptID;Lorg/apache/hadoop/mapred/SortedRanges$Range;Lorg/apache/hadoop/mapred/JvmContext;)V	
org.apache.hadoop.mapred.IsolationRunner$FakeUmbilical.updatePrivateDistributedCacheSizes(Lorg/apache/hadoop/mapreduce/JobID;[J)V	org.apache.hadoop.mapred.TaskUmbilicalProtocol.updatePrivateDistributedCacheSizes(Lorg/apache/hadoop/mapreduce/JobID;[J)V	
org.apache.hadoop.mapred.LocalJobRunner$Job.getTask(Lorg/apache/hadoop/mapred/JvmContext;)Lorg/apache/hadoop/mapred/JvmTask;	org.apache.hadoop.mapred.TaskUmbilicalProtocol.getTask(Lorg/apache/hadoop/mapred/JvmContext;)Lorg/apache/hadoop/mapred/JvmTask;	
org.apache.hadoop.mapred.LocalJobRunner$Job.statusUpdate(Lorg/apache/hadoop/mapred/TaskAttemptID;Lorg/apache/hadoop/mapred/TaskStatus;Lorg/apache/hadoop/mapred/JvmContext;)Z	org.apache.hadoop.mapred.TaskUmbilicalProtocol.statusUpdate(Lorg/apache/hadoop/mapred/TaskAttemptID;Lorg/apache/hadoop/mapred/TaskStatus;Lorg/apache/hadoop/mapred/JvmContext;)Z	
org.apache.hadoop.mapred.LocalJobRunner$Job.commitPending(Lorg/apache/hadoop/mapred/TaskAttemptID;Lorg/apache/hadoop/mapred/TaskStatus;Lorg/apache/hadoop/mapred/JvmContext;)V	org.apache.hadoop.mapred.TaskUmbilicalProtocol.commitPending(Lorg/apache/hadoop/mapred/TaskAttemptID;Lorg/apache/hadoop/mapred/TaskStatus;Lorg/apache/hadoop/mapred/JvmContext;)V	
org.apache.hadoop.mapred.LocalJobRunner$Job.reportDiagnosticInfo(Lorg/apache/hadoop/mapred/TaskAttemptID;Ljava/lang/String;Lorg/apache/hadoop/mapred/JvmContext;)V	org.apache.hadoop.mapred.TaskUmbilicalProtocol.reportDiagnosticInfo(Lorg/apache/hadoop/mapred/TaskAttemptID;Ljava/lang/String;Lorg/apache/hadoop/mapred/JvmContext;)V	
org.apache.hadoop.mapred.LocalJobRunner$Job.reportNextRecordRange(Lorg/apache/hadoop/mapred/TaskAttemptID;Lorg/apache/hadoop/mapred/SortedRanges$Range;Lorg/apache/hadoop/mapred/JvmContext;)V	org.apache.hadoop.mapred.TaskUmbilicalProtocol.reportNextRecordRange(Lorg/apache/hadoop/mapred/TaskAttemptID;Lorg/apache/hadoop/mapred/SortedRanges$Range;Lorg/apache/hadoop/mapred/JvmContext;)V	
org.apache.hadoop.mapred.LocalJobRunner$Job.ping(Lorg/apache/hadoop/mapred/TaskAttemptID;Lorg/apache/hadoop/mapred/JvmContext;)Z	org.apache.hadoop.mapred.TaskUmbilicalProtocol.ping(Lorg/apache/hadoop/mapred/TaskAttemptID;Lorg/apache/hadoop/mapred/JvmContext;)Z	
org.apache.hadoop.mapred.LocalJobRunner$Job.canCommit(Lorg/apache/hadoop/mapred/TaskAttemptID;Lorg/apache/hadoop/mapred/JvmContext;)Z	org.apache.hadoop.mapred.TaskUmbilicalProtocol.canCommit(Lorg/apache/hadoop/mapred/TaskAttemptID;Lorg/apache/hadoop/mapred/JvmContext;)Z	
org.apache.hadoop.mapred.LocalJobRunner$Job.done(Lorg/apache/hadoop/mapred/TaskAttemptID;Lorg/apache/hadoop/mapred/JvmContext;)V	org.apache.hadoop.mapred.TaskUmbilicalProtocol.done(Lorg/apache/hadoop/mapred/TaskAttemptID;Lorg/apache/hadoop/mapred/JvmContext;)V	
org.apache.hadoop.mapred.LocalJobRunner$Job.fsError(Lorg/apache/hadoop/mapred/TaskAttemptID;Ljava/lang/String;Lorg/apache/hadoop/mapred/JvmContext;)V	org.apache.hadoop.mapred.TaskUmbilicalProtocol.fsError(Lorg/apache/hadoop/mapred/TaskAttemptID;Ljava/lang/String;Lorg/apache/hadoop/mapred/JvmContext;)V	
org.apache.hadoop.mapred.LocalJobRunner$Job.shuffleError(Lorg/apache/hadoop/mapred/TaskAttemptID;Ljava/lang/String;Lorg/apache/hadoop/mapred/JvmContext;)V	org.apache.hadoop.mapred.TaskUmbilicalProtocol.shuffleError(Lorg/apache/hadoop/mapred/TaskAttemptID;Ljava/lang/String;Lorg/apache/hadoop/mapred/JvmContext;)V	
org.apache.hadoop.mapred.LocalJobRunner$Job.fatalError(Lorg/apache/hadoop/mapred/TaskAttemptID;Ljava/lang/String;Lorg/apache/hadoop/mapred/JvmContext;)V	org.apache.hadoop.mapred.TaskUmbilicalProtocol.fatalError(Lorg/apache/hadoop/mapred/TaskAttemptID;Ljava/lang/String;Lorg/apache/hadoop/mapred/JvmContext;)V	
org.apache.hadoop.mapred.LocalJobRunner$Job.getMapCompletionEvents(Lorg/apache/hadoop/mapred/JobID;IILorg/apache/hadoop/mapred/TaskAttemptID;Lorg/apache/hadoop/mapred/JvmContext;)Lorg/apache/hadoop/mapred/MapTaskCompletionEventsUpdate;	org.apache.hadoop.mapred.TaskUmbilicalProtocol.getMapCompletionEvents(Lorg/apache/hadoop/mapred/JobID;IILorg/apache/hadoop/mapred/TaskAttemptID;Lorg/apache/hadoop/mapred/JvmContext;)Lorg/apache/hadoop/mapred/MapTaskCompletionEventsUpdate;	
org.apache.hadoop.mapred.LocalJobRunner$Job.updatePrivateDistributedCacheSizes(Lorg/apache/hadoop/mapreduce/JobID;[J)V	org.apache.hadoop.mapred.TaskUmbilicalProtocol.updatePrivateDistributedCacheSizes(Lorg/apache/hadoop/mapreduce/JobID;[J)V	
org.apache.hadoop.mapred.TaskTracker.getTask(Lorg/apache/hadoop/mapred/JvmContext;)Lorg/apache/hadoop/mapred/JvmTask;	org.apache.hadoop.mapred.TaskUmbilicalProtocol.getTask(Lorg/apache/hadoop/mapred/JvmContext;)Lorg/apache/hadoop/mapred/JvmTask;	
org.apache.hadoop.mapred.TaskTracker.statusUpdate(Lorg/apache/hadoop/mapred/TaskAttemptID;Lorg/apache/hadoop/mapred/TaskStatus;Lorg/apache/hadoop/mapred/JvmContext;)Z	org.apache.hadoop.mapred.TaskUmbilicalProtocol.statusUpdate(Lorg/apache/hadoop/mapred/TaskAttemptID;Lorg/apache/hadoop/mapred/TaskStatus;Lorg/apache/hadoop/mapred/JvmContext;)Z	
org.apache.hadoop.mapred.TaskTracker.reportDiagnosticInfo(Lorg/apache/hadoop/mapred/TaskAttemptID;Ljava/lang/String;Lorg/apache/hadoop/mapred/JvmContext;)V	org.apache.hadoop.mapred.TaskUmbilicalProtocol.reportDiagnosticInfo(Lorg/apache/hadoop/mapred/TaskAttemptID;Ljava/lang/String;Lorg/apache/hadoop/mapred/JvmContext;)V	
org.apache.hadoop.mapred.TaskTracker.reportNextRecordRange(Lorg/apache/hadoop/mapred/TaskAttemptID;Lorg/apache/hadoop/mapred/SortedRanges$Range;Lorg/apache/hadoop/mapred/JvmContext;)V	org.apache.hadoop.mapred.TaskUmbilicalProtocol.reportNextRecordRange(Lorg/apache/hadoop/mapred/TaskAttemptID;Lorg/apache/hadoop/mapred/SortedRanges$Range;Lorg/apache/hadoop/mapred/JvmContext;)V	
org.apache.hadoop.mapred.TaskTracker.ping(Lorg/apache/hadoop/mapred/TaskAttemptID;Lorg/apache/hadoop/mapred/JvmContext;)Z	org.apache.hadoop.mapred.TaskUmbilicalProtocol.ping(Lorg/apache/hadoop/mapred/TaskAttemptID;Lorg/apache/hadoop/mapred/JvmContext;)Z	
org.apache.hadoop.mapred.TaskTracker.commitPending(Lorg/apache/hadoop/mapred/TaskAttemptID;Lorg/apache/hadoop/mapred/TaskStatus;Lorg/apache/hadoop/mapred/JvmContext;)V	org.apache.hadoop.mapred.TaskUmbilicalProtocol.commitPending(Lorg/apache/hadoop/mapred/TaskAttemptID;Lorg/apache/hadoop/mapred/TaskStatus;Lorg/apache/hadoop/mapred/JvmContext;)V	
org.apache.hadoop.mapred.TaskTracker.canCommit(Lorg/apache/hadoop/mapred/TaskAttemptID;Lorg/apache/hadoop/mapred/JvmContext;)Z	org.apache.hadoop.mapred.TaskUmbilicalProtocol.canCommit(Lorg/apache/hadoop/mapred/TaskAttemptID;Lorg/apache/hadoop/mapred/JvmContext;)Z	
org.apache.hadoop.mapred.TaskTracker.done(Lorg/apache/hadoop/mapred/TaskAttemptID;Lorg/apache/hadoop/mapred/JvmContext;)V	org.apache.hadoop.mapred.TaskUmbilicalProtocol.done(Lorg/apache/hadoop/mapred/TaskAttemptID;Lorg/apache/hadoop/mapred/JvmContext;)V	
org.apache.hadoop.mapred.TaskTracker.shuffleError(Lorg/apache/hadoop/mapred/TaskAttemptID;Ljava/lang/String;Lorg/apache/hadoop/mapred/JvmContext;)V	org.apache.hadoop.mapred.TaskUmbilicalProtocol.shuffleError(Lorg/apache/hadoop/mapred/TaskAttemptID;Ljava/lang/String;Lorg/apache/hadoop/mapred/JvmContext;)V	
org.apache.hadoop.mapred.TaskTracker.fsError(Lorg/apache/hadoop/mapred/TaskAttemptID;Ljava/lang/String;Lorg/apache/hadoop/mapred/JvmContext;)V	org.apache.hadoop.mapred.TaskUmbilicalProtocol.fsError(Lorg/apache/hadoop/mapred/TaskAttemptID;Ljava/lang/String;Lorg/apache/hadoop/mapred/JvmContext;)V	
org.apache.hadoop.mapred.TaskTracker.fatalError(Lorg/apache/hadoop/mapred/TaskAttemptID;Ljava/lang/String;Lorg/apache/hadoop/mapred/JvmContext;)V	org.apache.hadoop.mapred.TaskUmbilicalProtocol.fatalError(Lorg/apache/hadoop/mapred/TaskAttemptID;Ljava/lang/String;Lorg/apache/hadoop/mapred/JvmContext;)V	
org.apache.hadoop.mapred.TaskTracker.getMapCompletionEvents(Lorg/apache/hadoop/mapred/JobID;IILorg/apache/hadoop/mapred/TaskAttemptID;Lorg/apache/hadoop/mapred/JvmContext;)Lorg/apache/hadoop/mapred/MapTaskCompletionEventsUpdate;	org.apache.hadoop.mapred.TaskUmbilicalProtocol.getMapCompletionEvents(Lorg/apache/hadoop/mapred/JobID;IILorg/apache/hadoop/mapred/TaskAttemptID;Lorg/apache/hadoop/mapred/JvmContext;)Lorg/apache/hadoop/mapred/MapTaskCompletionEventsUpdate;	
org.apache.hadoop.mapred.TaskTracker.updatePrivateDistributedCacheSizes(Lorg/apache/hadoop/mapreduce/JobID;[J)V	org.apache.hadoop.mapred.TaskUmbilicalProtocol.updatePrivateDistributedCacheSizes(Lorg/apache/hadoop/mapreduce/JobID;[J)V	
org.apache.hadoop.mapred.JobTracker.getBuildVersion()Ljava/lang/String;	org.apache.hadoop.mapred.InterTrackerProtocol.getBuildVersion()Ljava/lang/String;	
org.apache.hadoop.mapred.JobTracker.heartbeat(Lorg/apache/hadoop/mapred/TaskTrackerStatus;ZZZS)Lorg/apache/hadoop/mapred/HeartbeatResponse;	org.apache.hadoop.mapred.InterTrackerProtocol.heartbeat(Lorg/apache/hadoop/mapred/TaskTrackerStatus;ZZZS)Lorg/apache/hadoop/mapred/HeartbeatResponse;	
org.apache.hadoop.mapred.JobTracker.getFilesystemName()Ljava/lang/String;	org.apache.hadoop.mapred.InterTrackerProtocol.getFilesystemName()Ljava/lang/String;	org.apache.hadoop.mapred.JobSubmissionProtocol.getFilesystemName()Ljava/lang/String;	
org.apache.hadoop.mapred.JobTracker.reportTaskTrackerError(Ljava/lang/String;Ljava/lang/String;Ljava/lang/String;)V	org.apache.hadoop.mapred.InterTrackerProtocol.reportTaskTrackerError(Ljava/lang/String;Ljava/lang/String;Ljava/lang/String;)V	
org.apache.hadoop.mapred.JobTracker.getNewJobId()Lorg/apache/hadoop/mapred/JobID;	org.apache.hadoop.mapred.JobSubmissionProtocol.getNewJobId()Lorg/apache/hadoop/mapred/JobID;	
org.apache.hadoop.mapred.JobTracker.submitJob(Lorg/apache/hadoop/mapred/JobID;Ljava/lang/String;Lorg/apache/hadoop/security/Credentials;)Lorg/apache/hadoop/mapred/JobStatus;	org.apache.hadoop.mapred.JobSubmissionProtocol.submitJob(Lorg/apache/hadoop/mapred/JobID;Ljava/lang/String;Lorg/apache/hadoop/security/Credentials;)Lorg/apache/hadoop/mapred/JobStatus;	
org.apache.hadoop.mapred.JobTracker.getStagingAreaDir()Ljava/lang/String;	org.apache.hadoop.mapred.JobSubmissionProtocol.getStagingAreaDir()Ljava/lang/String;	
org.apache.hadoop.mapred.JobTracker.getClusterStatus(Z)Lorg/apache/hadoop/mapred/ClusterStatus;	org.apache.hadoop.mapred.JobSubmissionProtocol.getClusterStatus(Z)Lorg/apache/hadoop/mapred/ClusterStatus;	
org.apache.hadoop.mapred.JobTracker.killJob(Lorg/apache/hadoop/mapred/JobID;)V	org.apache.hadoop.mapred.JobSubmissionProtocol.killJob(Lorg/apache/hadoop/mapred/JobID;)V	
org.apache.hadoop.mapred.JobTracker.cancelDelegationToken(Lorg/apache/hadoop/security/token/Token;)V	org.apache.hadoop.mapred.JobSubmissionProtocol.cancelDelegationToken(Lorg/apache/hadoop/security/token/Token;)V	
org.apache.hadoop.mapred.JobTracker.getDelegationToken(Lorg/apache/hadoop/io/Text;)Lorg/apache/hadoop/security/token/Token;	org.apache.hadoop.mapred.JobSubmissionProtocol.getDelegationToken(Lorg/apache/hadoop/io/Text;)Lorg/apache/hadoop/security/token/Token;	
org.apache.hadoop.mapred.JobTracker.renewDelegationToken(Lorg/apache/hadoop/security/token/Token;)J	org.apache.hadoop.mapred.JobSubmissionProtocol.renewDelegationToken(Lorg/apache/hadoop/security/token/Token;)J	
org.apache.hadoop.mapred.JobTracker.setJobPriority(Lorg/apache/hadoop/mapred/JobID;Ljava/lang/String;)V	org.apache.hadoop.mapred.JobSubmissionProtocol.setJobPriority(Lorg/apache/hadoop/mapred/JobID;Ljava/lang/String;)V	
org.apache.hadoop.mapred.JobTracker.getJobProfile(Lorg/apache/hadoop/mapred/JobID;)Lorg/apache/hadoop/mapred/JobProfile;	org.apache.hadoop.mapred.JobSubmissionProtocol.getJobProfile(Lorg/apache/hadoop/mapred/JobID;)Lorg/apache/hadoop/mapred/JobProfile;	
org.apache.hadoop.mapred.JobTracker.getJobStatus(Lorg/apache/hadoop/mapred/JobID;)Lorg/apache/hadoop/mapred/JobStatus;	org.apache.hadoop.mapred.JobSubmissionProtocol.getJobStatus(Lorg/apache/hadoop/mapred/JobID;)Lorg/apache/hadoop/mapred/JobStatus;	
org.apache.hadoop.mapred.JobTracker.getJobCounters(Lorg/apache/hadoop/mapred/JobID;)Lorg/apache/hadoop/mapred/Counters;	org.apache.hadoop.mapred.JobSubmissionProtocol.getJobCounters(Lorg/apache/hadoop/mapred/JobID;)Lorg/apache/hadoop/mapred/Counters;	
org.apache.hadoop.mapred.JobTracker.getMapTaskReports(Lorg/apache/hadoop/mapred/JobID;)[Lorg/apache/hadoop/mapred/TaskReport;	org.apache.hadoop.mapred.JobSubmissionProtocol.getMapTaskReports(Lorg/apache/hadoop/mapred/JobID;)[Lorg/apache/hadoop/mapred/TaskReport;	
org.apache.hadoop.mapred.JobTracker.getReduceTaskReports(Lorg/apache/hadoop/mapred/JobID;)[Lorg/apache/hadoop/mapred/TaskReport;	org.apache.hadoop.mapred.JobSubmissionProtocol.getReduceTaskReports(Lorg/apache/hadoop/mapred/JobID;)[Lorg/apache/hadoop/mapred/TaskReport;	
org.apache.hadoop.mapred.JobTracker.getCleanupTaskReports(Lorg/apache/hadoop/mapred/JobID;)[Lorg/apache/hadoop/mapred/TaskReport;	org.apache.hadoop.mapred.JobSubmissionProtocol.getCleanupTaskReports(Lorg/apache/hadoop/mapred/JobID;)[Lorg/apache/hadoop/mapred/TaskReport;	
org.apache.hadoop.mapred.JobTracker.getSetupTaskReports(Lorg/apache/hadoop/mapred/JobID;)[Lorg/apache/hadoop/mapred/TaskReport;	org.apache.hadoop.mapred.JobSubmissionProtocol.getSetupTaskReports(Lorg/apache/hadoop/mapred/JobID;)[Lorg/apache/hadoop/mapred/TaskReport;	
org.apache.hadoop.mapred.JobTracker.getTaskCompletionEvents(Lorg/apache/hadoop/mapred/JobID;II)[Lorg/apache/hadoop/mapred/TaskCompletionEvent;	org.apache.hadoop.mapred.InterTrackerProtocol.getTaskCompletionEvents(Lorg/apache/hadoop/mapred/JobID;II)[Lorg/apache/hadoop/mapred/TaskCompletionEvent;	org.apache.hadoop.mapred.JobSubmissionProtocol.getTaskCompletionEvents(Lorg/apache/hadoop/mapred/JobID;II)[Lorg/apache/hadoop/mapred/TaskCompletionEvent;	
org.apache.hadoop.mapred.JobTracker.getTaskDiagnostics(Lorg/apache/hadoop/mapred/TaskAttemptID;)[Ljava/lang/String;	org.apache.hadoop.mapred.JobSubmissionProtocol.getTaskDiagnostics(Lorg/apache/hadoop/mapred/TaskAttemptID;)[Ljava/lang/String;	
org.apache.hadoop.mapred.JobTracker.killTask(Lorg/apache/hadoop/mapred/TaskAttemptID;Z)Z	org.apache.hadoop.mapred.JobSubmissionProtocol.killTask(Lorg/apache/hadoop/mapred/TaskAttemptID;Z)Z	
org.apache.hadoop.mapred.JobTracker.jobsToComplete()[Lorg/apache/hadoop/mapred/JobStatus;	org.apache.hadoop.mapred.JobSubmissionProtocol.jobsToComplete()[Lorg/apache/hadoop/mapred/JobStatus;	
org.apache.hadoop.mapred.JobTracker.getAllJobs()[Lorg/apache/hadoop/mapred/JobStatus;	org.apache.hadoop.mapred.JobSubmissionProtocol.getAllJobs()[Lorg/apache/hadoop/mapred/JobStatus;	
org.apache.hadoop.mapred.JobTracker.getSystemDir()Ljava/lang/String;	org.apache.hadoop.mapred.InterTrackerProtocol.getSystemDir()Ljava/lang/String;	org.apache.hadoop.mapred.JobSubmissionProtocol.getSystemDir()Ljava/lang/String;	
org.apache.hadoop.mapred.JobTracker.getQueueAdmins(Ljava/lang/String;)Lorg/apache/hadoop/security/authorize/AccessControlList;	org.apache.hadoop.mapred.JobSubmissionProtocol.getQueueAdmins(Ljava/lang/String;)Lorg/apache/hadoop/security/authorize/AccessControlList;	
org.apache.hadoop.mapred.JobTracker.refreshNodes()V	org.apache.hadoop.mapred.AdminOperationsProtocol.refreshNodes()V	
org.apache.hadoop.mapred.JobTracker.getQueues()[Lorg/apache/hadoop/mapred/JobQueueInfo;	org.apache.hadoop.mapred.JobSubmissionProtocol.getQueues()[Lorg/apache/hadoop/mapred/JobQueueInfo;	
org.apache.hadoop.mapred.JobTracker.getQueueInfo(Ljava/lang/String;)Lorg/apache/hadoop/mapred/JobQueueInfo;	org.apache.hadoop.mapred.JobSubmissionProtocol.getQueueInfo(Ljava/lang/String;)Lorg/apache/hadoop/mapred/JobQueueInfo;	
org.apache.hadoop.mapred.JobTracker.getJobsFromQueue(Ljava/lang/String;)[Lorg/apache/hadoop/mapred/JobStatus;	org.apache.hadoop.mapred.JobSubmissionProtocol.getJobsFromQueue(Ljava/lang/String;)[Lorg/apache/hadoop/mapred/JobStatus;	
org.apache.hadoop.mapred.JobTracker.getQueueAclsForCurrentUser()[Lorg/apache/hadoop/mapred/QueueAclsInfo;	org.apache.hadoop.mapred.JobSubmissionProtocol.getQueueAclsForCurrentUser()[Lorg/apache/hadoop/mapred/QueueAclsInfo;	
org.apache.hadoop.mapred.JobTracker.refreshQueues()V	org.apache.hadoop.mapred.AdminOperationsProtocol.refreshQueues()V	
